R  1600 1600

NO ./textures/redbrick.xpm
SO ./textures/doom.xpm
WE ./textures/wall.xpm
EA ./textures/eagle.xpm

S ./textures/skeleton.xpm
F 255,255,0
C 255,255,0

1111111111111
10002E0000001
1111111111111